###################
#m....$.$.$.$....m#
###.#.#######.#.###
#...m...##...m....#
#.......##.....$###
#..##...###......m#
#......m.####...###
#####.............#
#p.......##......$#
###################