###############################
#$.......#...........#....$.#p#
#..m.................#......#.#
#############........###..###.#
#..$.#...............#........#
#.....#########.##...#....#####
#...m.........................#
#.................#.......m...#
########.########.##.......#.$#
#$.$.$.m.#$.$.$.m.m.m.m...#$$$#
###############################